##########################################
#=\..  ..  .. . . . . . . . . . . . . . %#
## ############ ##########################
############### ##########################
##########################################
