###################################################################################################################
#.                                                                                                               .#
# =                                                                                                          =    #
#                                                                                                                 #
#                                                                                                                 #
#                                                                                                                 #
#                                                                                                                 #
#                                                                                                                 #
#                                                                                                                 #
#                                                                                                                 #
#                                                                                                                 #
#                                                                                                                 #
#                                                                                                                 #
#                                                                                                                 #
#                                                                                                                 #
#                                                                                                                 #
#                                                                                                                 #
#                                                                                                                 #
#                                                                                                                 #
#                                                                                                                 #
#                                                                                                                 #
#                                                                                                                 #
#                                                                                                                 #
#                                                                                                                 #
#                                                        %                                                        #
#                                                                                                                 #
#                                                                                                                 #
#                                                                                                                 #
#                                                                                                                 #
#                                                                                                                 #
#                                                                                                                 #
#                                                                                                                 #
#                                                                                                                 #
#                                                                                                                 #
#                                                                                                                 #
#                                                                                                                 #
#                                                                                                                 #
#                                                                                                                 #
#                                                                                                                 #
#                                                                                                                 #
#                                                                                                                 #
#                                                                                                                 #
#                                                                                                                 #
#                                                                                                                 #
#                                                                                                                 #
#                                                                                                                 #
#                                                                                                                 #
#                                                                                                                 #
#                                                                                                                 #
#                                                                                                                 #
#                                                                                                                 #
#                                                                                                                 #
#                                                                                                                 #
#                                                                                                                 #
#                                                                                                                 #
#                                                                                                                 #
#                                                                                                                 #
#                                                                                                                 #
#                                                                                                                 #
#                                                                                                                 #
#                                                                                                                 #
#                                                                                                                 #
#                                                                                                                 #
#                                                                                                                 #
#                                                                                                                 #
#                                                                                                                 #
#                                                                                                                 #
#                                                                                                                 #
#                                                                                                                 #
#                                                                                                                 #
#                                                                                                                 #
#                                                                                                                 #
#                                                     \                                                           #
#                                                                                                                 #
#                                                                                                                 #
#                                                                                                                 #
#                                                                                                                 #
#                                                                                                                 #
#                                                                                                                 #
#                                                                                                                 #
#                                                                                                                 #
#                                                                                                                 #
#                                                                                                                 #
#                                                                                                                 #
#                                                                                                                 #
#                                                                                                                 #
#                                                                                                                 #
#                                                                                                                 #
#                                                                                                                 #
#                                                                                                                 #
#                                                                                                                 #
#                                                                                                                 #
#                                                                                                                 #
#                                                                                                                 #
#                                                                                                                 #
#                                                                                                                 #
#                                                                                                                 #
#    =                                                                                                      =     #
#.                                                                                                              . #
###################################################################################################################
