#########
#.= . =.#
# ##.## #
# # \ # #
#. .#. .#
# # % # #
# ##.## #
#.= . =.#
#########
