#########
#=     =#
# ##### #
# # \ # #
#.#.#.#.#
# # % # #
# ##### #
#=     =#
#########
