#######################
#         \      =    #
#.#.#.#.#.#.#.#.#.#.#.#
#                     #
#.#.#.#.#.#.#.#.#.#.#.#
#                     #
#.#.#.#.#.#.#.#.#.#.#.#
#                     #
#.#.#.#.#.#.#.#.#.#.#.#
#                     #
#.#.#.#.#.#.#.#.#.#.#.#
#                     #
#.#.#.#.#.#.#.#.#.#.#.#
#    =    %           #
#######################
